1111111111111111111111111111
1C000001C0000000000000000001
1010010100111100111001010101
1P100101001000001C1001C101E1
1111111111111111111111111111