1111111111111111111111111111
1C000001C0000000000000000001
1010010100111100111001010101
10100101001000001C1001C10101
1010010110101110101001110101
101C01001C0000001000000000C1
1011110011101110101111111111
1P0000000000C01C1000000000E1
1111111111111111111111111111