1111111111111111111111111111
1000000000000000000000000E01
1000000000000000000000000001
1000000000000000000000000001
1000000000000000000000000001
1000000000000000000000000001
10000000000000C0000000000001
1000000000000000000000000001
1000000000000000000000000001
1000000000000000000000000001
10000000000C0000000000000001
1000000000000000000000000001
1000000000000000000000000001
1P00000000000000000000000001
1111111111111111111111111111