111111111111
1000000000P1
100111111111
1C00000000E1
111111111111