111111111111
1000000000P1
10011111111E
1C0000000001
111111101111