111111111111111111111111111111111
100000010000110000100010100010001
100100011000110000100101000000001
111100010111000C11000000011000001
100000010000000001111010101011001
1111110001111P1010010001101001001
110001000001011010011000001011001
100010000101100101000010100100001
100110100000010001001000001010001
100010100000000000101110001000001
100110100011110011000C01100000011
100000000000100111000100011000101
100000101110010000011000000001011
100000001100100101000000E00001101
101100010111101011C001000000C0111
100000101110000011000000000000001
110000000001010110100101000101001
11C0001C0000010110C10000000000001
10011100000000010011010000C001111
111111111111111111111111111111111